Links House <=> Links House Exit
Links House <= Chris Houlihan Room Exit
Tavern North => Tavern
Kakariko Well Drop => Lost Woods Hideout (top)
Pyramid Hole => Kakariko Well (top)
Skull Woods First Section Hole (East) => Skull Woods Second Section (Drop)
Skull Woods First Section Hole (North) => Lumberjack Tree (top)
Sanctuary Grave => North Fairy Cave
Skull Woods First Section Hole (West) => Skull Woods First Section (Left)
Skull Woods Second Section Hole => Pyramid
Hyrule Castle Secret Entrance Drop => Bat Cave (right)
Lumberjack Tree Tree => Hyrule Castle Secret Entrance
Lost Woods Hideout Drop => Skull Woods First Section (Top)
Bat Cave Drop => Skull Woods First Section (Right)
North Fairy Cave Drop => Sewer Drop
Bumper Cave (Top) <= Spectacle Rock Cave Exit
Hyrule Castle Entrance (South) => Spectacle Rock Cave Exit
Hookshot Cave Back Entrance <= Turtle Rock Exit (Front)
Pyramid Entrance => Turtle Rock Exit (Front)
Dark Death Mountain Ledge (East) <= Fairy Ascension Cave Exit (Top)
Ganons Tower => Fairy Ascension Cave Exit (Top)
Turtle Rock Isolated Ledge Entrance <= Bumper Cave Exit (Bottom)
Hyrule Castle Secret Entrance Stairs => Bumper Cave Exit (Bottom)
Desert Palace Entrance (East) <= Desert Palace Exit (West)
Light World Bomb Hut => Desert Palace Exit (West)
Skull Woods Second Section Door (West) <= Hookshot Cave Exit (North)
Paradox Cave (Top) => Hookshot Cave Exit (North)
Pyramid Entrance <= Superbunny Cave Exit (Top)
Two Brothers House (East) => Superbunny Cave Exit (Top)
Death Mountain Return Cave (East) <= Old Man Cave Exit (East)
Chest Game => Old Man Cave Exit (East)
Desert Fairy => Blacksmiths Hut
Dark World Potion Shop => Big Bomb Shop
Hyrule Castle Entrance (South) <= Pyramid Exit
Dark Lake Hylia Ledge Fairy => Pyramid Exit
Lost Woods Hideout Stump <= Ganons Tower Exit
Big Bomb Shop => Ganons Tower Exit
Hyrule Castle Secret Entrance Stairs <= Desert Palace Exit (North)
Good Bee Cave => Desert Palace Exit (North)
Fairy Ascension Cave (Bottom) <= Skull Woods First Section Exit
Mini Moldorm Cave => Skull Woods First Section Exit
Spectacle Rock Cave (Bottom) <= Sanctuary Exit
Sahasrahlas Hut => Sanctuary Exit
Lumberjack Tree Cave <= Kakariko Well Exit
Kakariko Gamble Game => Kakariko Well Exit
Kakariko Well Cave <= Hyrule Castle Exit (South)
Skull Woods Final Section => Hyrule Castle Exit (South)
Old Man Cave (West) <= Hyrule Castle Exit (West)
Elder House (West) => Hyrule Castle Exit (West)
Desert Palace Entrance (South) <= Hyrule Castle Exit (East)
Sick Kids House => Hyrule Castle Exit (East)
Eastern Palace <= Tower of Hera Exit
Lake Hylia Fairy => Tower of Hera Exit
Tower of Hera <= Spectacle Rock Cave Exit (Peak)
Dark Sanctuary Hint => Spectacle Rock Cave Exit (Peak)
Hookshot Cave <= Spectacle Rock Cave Exit (Top)
Blacksmiths Hut => Spectacle Rock Cave Exit (Top)
Paradox Cave (Middle) <= Elder House Exit (East)
Blinds Hideout => Elder House Exit (East)
Hyrule Castle Entrance (West) <= Elder House Exit (West)
Kakariko Shop => Elder House Exit (West)
North Fairy Cave <= Skull Woods Final Section Exit
Spectacle Rock Cave Peak => Skull Woods Final Section Exit
Death Mountain Return Cave (West) <= North Fairy Cave Exit
Lost Woods Hideout Stump => North Fairy Cave Exit
Ganons Tower <= Hyrule Castle Secret Entrance Exit
Desert Palace Entrance (East) => Hyrule Castle Secret Entrance Exit
Spectacle Rock Cave Peak <= Skull Woods Second Section Exit (East)
20 Rupee Cave => Skull Woods Second Section Exit (East)
Fairy Ascension Cave (Top) <= Eastern Palace Exit
Agahnims Tower => Eastern Palace Exit
Bumper Cave (Bottom) <= Old Man House Exit (Top)
Dam => Old Man House Exit (Top)
Paradox Cave (Bottom) <= Agahnims Tower Exit
Old Man House (Bottom) => Agahnims Tower Exit
Old Man Cave (East) <= Lost Woods Hideout Exit
Capacity Upgrade => Lost Woods Hideout Exit
Palace of Darkness <= Swamp Palace Exit
Hyrule Castle Entrance (West) => Swamp Palace Exit
Elder House (West) <= Paradox Cave Exit (Top)
Waterfall of Wishing => Paradox Cave Exit (Top)
Superbunny Cave (Bottom) <= Paradox Cave Exit (Middle)
Old Man House (Top) => Paradox Cave Exit (Middle)
Agahnims Tower <= Paradox Cave Exit (Bottom)
Old Man Cave (West) => Paradox Cave Exit (Bottom)
Thieves Town <= Bat Cave Exit
Skull Woods Second Section Door (East) => Bat Cave Exit
Old Man House (Bottom) <= Skull Woods Second Section Exit (West)
Dark Death Mountain Ledge (West) => Skull Woods Second Section Exit (West)
Hyrule Castle Entrance (East) <= Spiral Cave Exit (Top)
Brewery => Spiral Cave Exit (Top)
Superbunny Cave (Top) <= Spiral Cave Exit
Long Fairy Cave => Spiral Cave Exit
Turtle Rock <= Lumberjack Tree Exit
Elder House (East) => Lumberjack Tree Exit
Bat Cave Cave <= Thieves Town Exit
Death Mountain Return Cave (West) => Thieves Town Exit
Dark Death Mountain Ledge (West) <= Two Brothers House Exit (East)
Dark Lake Hylia Fairy => Two Brothers House Exit (East)
Two Brothers House (East) <= Two Brothers House Exit (West)
Hookshot Cave Back Entrance => Two Brothers House Exit (West)
Misery Mire <= Hookshot Cave Exit (South)
Checkerboard Cave => Hookshot Cave Exit (South)
Ice Palace <= Turtle Rock Ledge Exit (East)
Bat Cave Cave => Turtle Rock Ledge Exit (East)
Desert Palace Entrance (North) <= Turtle Rock Isolated Ledge Exit
Spiral Cave (Bottom) => Turtle Rock Isolated Ledge Exit
Sanctuary <= Turtle Rock Ledge Exit (West)
Graveyard Cave => Turtle Rock Ledge Exit (West)
Skull Woods First Section Door <= Old Man House Exit (Bottom)
Mire Shed => Old Man House Exit (Bottom)
Old Man House (Top) <= Fairy Ascension Cave Exit (Bottom)
Lumberjack House => Fairy Ascension Cave Exit (Bottom)
Paradox Cave (Top) <= Misery Mire Exit
Hookshot Fairy => Misery Mire Exit
Two Brothers House (West) <= Palace of Darkness Exit
Ice Palace => Palace of Darkness Exit
Desert Palace Entrance (West) <= Bumper Cave Exit (Top)
Mimic Cave => Bumper Cave Exit (Top)
Spectacle Rock Cave <= Desert Palace Exit (South)
Library => Desert Palace Exit (South)
Spiral Cave <= Desert Palace Exit (East)
Pyramid Fairy => Desert Palace Exit (East)
Spiral Cave (Bottom) <= Death Mountain Return Cave Exit (East)
Misery Mire => Death Mountain Return Cave Exit (East)
Swamp Palace <= Death Mountain Return Cave Exit (West)
Turtle Rock => Death Mountain Return Cave Exit (West)
Skull Woods Final Section <= Ice Palace Exit
Old Man Cave (East) => Ice Palace Exit
Elder House (East) <= Superbunny Cave Exit (Bottom)
Desert Palace Entrance (West) => Superbunny Cave Exit (Bottom)
Skull Woods Second Section Door (East) <= Old Man Cave Exit (West)
Bonk Rock Cave => Old Man Cave Exit (West)
Dark World Hammer Peg Cave => Spike Cave
Red Shield Shop => Lumberjack House
Dark Lake Hylia Shop => Village of Outcasts Shop
C-Shaped House => East Dark World Hint
Village of Outcasts Shop => Mini Moldorm Cave
Paradox Cave (Middle) => Capacity Upgrade
Dark Lake Hylia Ledge Spike Cave => Dark World Lumberjack Shop
Fortune Teller (Light) => Dam
Superbunny Cave (Bottom) => Dark Lake Hylia Healer Fairy
Cave Shop (Dark Death Mountain) => Dark Sanctuary Hint
Lost Woods Gamble => Dark World Hammer Peg Cave
Sanctuary => Dark Desert Hint
Bonk Fairy (Dark) => Long Fairy Cave
Tower of Hera => Dark Lake Hylia Ledge Hint
Spiral Cave => Cave Shop (Dark Death Mountain)
Desert Palace Entrance (North) => Library
Paradox Cave (Bottom) => Dark Desert Healer Fairy
Desert Palace Entrance (South) => Cave Shop (Lake Hylia)
Thieves Town => Kakariko Gamble Game
Eastern Palace => Lost Woods Gamble
Lumberjack Tree Cave => Pyramid Fairy
Swamp Palace => Dark Death Mountain Healer Fairy
Bumper Cave (Bottom) => Swamp Healer Fairy
50 Rupee Cave => Aginahs Cave
Bush Covered House => Checkerboard Cave
Turtle Rock Isolated Ledge Entrance => Bush Covered House
Fortune Teller (Dark) => Chest Game
Hype Cave => Hype Cave
Dark Lake Hylia Ledge Hint => Kakariko Shop
Potion Shop => Snitch Lady (West)
Kings Grave => Bonk Rock Cave
Archery Game => Fortune Teller (Light)
Superbunny Cave (Top) => Blinds Hideout
Two Brothers House (West) => Kings Grave
Hookshot Cave => Bonk Fairy (Dark)
Bonk Fairy (Light) => Lake Hylia Fortune Teller
Skull Woods Second Section Door (West) => Good Bee Cave
Dark Desert Fairy => Light World Bomb Hut
Spike Cave => Hookshot Fairy
Cave Shop (Lake Hylia) => Brewery
Aginahs Cave => Archery Game
Dark World Lumberjack Shop => Dark Lake Hylia Ledge Spike Cave
Palace of Darkness Hint => Dark World Potion Shop
Dark Desert Hint => Mire Shed
Palace of Darkness => C-Shaped House
Fairy Ascension Cave (Bottom) => Dark Lake Hylia Shop
Hyrule Castle Entrance (East) => Ice Rod Cave
Snitch Lady (West) => Bonk Fairy (Light)
East Dark World Hint => Chicken House
Cave 45 => Fortune Teller (Dark)
Fairy Ascension Cave (Top) => Palace of Darkness Hint
Death Mountain Return Cave (East) => Dark Lake Hylia Ledge Healer Fairy
Lake Hylia Fortune Teller => 50 Rupee Cave
Spectacle Rock Cave => Snitch Lady (East)
Ice Rod Cave => Potion Shop
Dark Death Mountain Fairy => Red Shield Shop
Bumper Cave (Top) => 20 Rupee Cave
Tavern (Front) => Waterfall of Wishing
Skull Woods First Section Door => Sahasrahlas Hut
Snitch Lady (East) => Tavern (Front)
North Fairy Cave => Desert Healer Fairy
Light Hype Fairy => Graveyard Cave
Kakariko Well Cave => Sick Kids House
Dark Death Mountain Ledge (East) => Mimic Cave
Chicken House => Cave 45
Spectacle Rock Cave (Bottom) => Lake Hylia Healer Fairy